NO ./greystone.xpm
SO ./greystone.xpm
WE ./greystone.xpm
EA ./greystone.xpm


F 220,100,0
C 255,0,0


		1111111111111111111111111111111111111111111111111111111111111
		1000000000000000000000000000000000000000000000000000100000001
		1000000000000000000000000000000000000000000000000000100000001
		1000000000000000000000000000000000000000000000000000100000001
1111111110000000000000000000000000000000000000000000000000000100000001
1E0000000000000000000000000000000000000000000000000000000000111111111
100000000000000000000000000000000000000000000000000000000000011
100000000000000000000000000000000000000000000000000000000000011
110000001000000000000000000000000000000000000000000000000000010
100000000000000000000000000000000000000000000000000000000000011
100000000000000000000000000000000000000000000000000000000000011
110000010000000000000000000000000000000000000000000000000000011
111101110000000000000000000000000000000000000000000000000000011
111111111111111111111111111111111111111111111111111111111111111