NO ./greystone.xpm
SO ./greystone.xpm
WE ./greystone.xpm
EA ./greystone.xpm

F 30,30,30
C 120,120,aa

111111
100001
10N001
100001
111111
